1 1 1 1 1 1 1 1 1 1 2 5 5 2 1 1 1 1 1 1 1 1 1 1 1 1 1 1 1 1 1 1 1 1 1 1 1 1 1 1 1 1 1 1 1 1 1 1 1 1
1 2 2 2 2 2 2 2 2 2 2 5 5 2 1 1 1 1 1 4 1 1 1 1 1 1 1 4 1 1 1 1 1 1 1 1 1 1 1 1 1 1 1 1 1 1 1 1 1 1
1 2 5 5 5 5 5 5 5 5 5 5 5 2 1 8 1 1 1 1 1 1 1 1 1 1 1 1 1 1 1 1 1 1 1 1 1 1 1 1 1 1 1 1 1 1 1 1 1 1
1 2 5 5 5 5 5 5 5 5 5 5 5 2 1 3 1 1 1 1 1 1 1 1 1 1 1 1 1 1 4 1 1 1 1 1 1 1 1 1 1 1 1 1 1 1 1 1 1 1
1 2 5 5 2 2 2 2 2 2 2 2 2 2 1 6 1 1 1 1 4 1 1 1 1 1 1 1 1 1 1 1 1 1 1 1 1 1 1 1 1 1 1 1 4 1 1 1 1 1
1 2 5 5 2 1 4 1 1 1 1 1 1 1 1 1 1 1 1 1 4 1 1 1 1 1 1 1 1 1 1 1 1 1 1 1 1 1 4 1 1 1 1 4 4 1 1 1 1 1
1 2 5 5 2 1 1 1 1 1 1 1 1 1 1 1 1 1 1 1 8 1 1 1 1 1 1 1 1 1 1 1 1 1 1 1 1 1 1 1 1 1 1 1 4 4 1 1 1 1
1 2 5 5 2 1 1 1 1 1 1 1 1 1 1 1 1 1 1 1 3 1 1 1 1 1 1 1 1 1 1 1 1 1 1 1 1 1 1 1 1 1 1 1 1 1 1 1 1 1
1 2 5 5 2 1 1 4 1 1 1 1 1 1 1 1 1 1 1 1 6 1 1 1 1 4 1 1 1 1 1 1 1 4 1 1 1 1 1 1 1 1 1 1 1 1 1 1 1 1
1 2 5 5 2 1 1 1 1 1 1 1 1 1 1 1 1 1 1 1 1 1 1 1 1 1 1 1 1 1 1 1 1 1 1 1 1 1 1 1 1 4 8 8 1 1 1 1 1 1
1 2 5 5 2 1 1 1 8 1 1 1 1 1 1 1 1 1 1 1 1 1 1 1 1 1 1 1 1 1 1 1 1 1 1 1 1 1 1 1 1 1 3 3 1 1 1 1 1 1
1 2 5 5 2 1 1 1 3 1 1 1 1 1 1 1 1 1 1 1 1 1 1 1 1 1 1 1 1 1 1 1 1 1 1 1 1 1 1 1 1 1 6 6 1 1 1 1 1 1
1 2 5 5 2 1 1 1 6 1 1 1 4 1 1 1 1 1 1 1 1 1 2 5 5 2 1 1 1 1 1 1 1 1 1 1 1 1 1 1 1 1 1 4 1 1 1 1 1 1
1 2 5 5 2 1 1 1 1 1 1 1 1 1 1 1 1 1 1 1 1 1 2 5 5 2 1 1 1 1 1 1 4 4 1 1 1 1 1 1 1 1 1 1 1 1 1 1 1 1
1 2 5 5 2 1 1 1 1 1 1 1 1 1 1 1 1 1 1 1 1 1 2 5 5 2 1 1 1 1 1 1 1 4 1 1 1 1 1 1 1 1 1 1 1 1 1 1 2 1
1 2 5 5 2 1 1 1 1 1 1 1 1 1 1 1 1 1 1 1 1 1 2 5 5 2 2 2 2 2 2 2 2 2 2 2 2 2 2 2 2 2 2 2 2 2 2 2 2 1
1 2 5 5 2 2 2 2 2 2 2 2 2 2 2 2 2 1 1 1 1 1 2 5 5 5 5 5 5 5 5 5 5 5 5 5 5 5 5 5 5 5 5 5 5 5 5 5 2 1
1 2 5 5 5 5 5 5 5 5 5 5 5 5 5 5 2 1 8 1 1 1 2 5 5 5 5 5 5 5 5 5 5 5 5 5 5 5 5 5 5 5 5 5 5 5 5 5 2 1
1 2 5 5 5 5 5 5 5 5 5 5 5 5 5 5 2 1 3 4 1 1 2 2 2 2 2 5 5 2 2 2 2 2 2 2 2 2 2 2 2 1 8 1 1 1 2 2 2 1
1 2 2 2 2 2 2 2 2 2 2 2 2 2 5 5 2 1 6 1 1 1 1 1 1 1 2 5 5 2 1 1 1 1 4 1 1 1 1 1 1 1 3 1 1 1 1 1 1 1
1 1 1 1 1 1 1 1 1 1 1 1 1 2 5 5 2 1 1 1 1 1 1 1 1 1 2 5 5 2 1 1 1 1 1 1 1 1 1 4 1 4 6 1 1 1 1 1 1 1
1 1 1 1 1 1 1 1 1 1 1 1 4 2 5 5 2 1 1 1 1 1 4 1 1 1 2 5 5 2 1 1 1 1 1 1 1 1 1 1 1 1 1 1 1 1 1 1 1 1
1 1 1 1 1 1 1 1 1 1 1 1 1 2 5 5 2 1 1 1 1 1 1 1 1 1 2 5 5 2 1 1 1 1 1 1 1 1 1 1 1 1 1 1 1 1 1 1 1 1
1 1 7 1 1 1 1 1 1 1 1 1 1 2 5 5 2 1 1 1 1 1 1 4 1 1 2 5 5 2 1 1 1 1 1 1 1 1 1 1 1 1 1 1 1 1 1 1 1 1
1 1 1 1 1 1 1 1 1 1 1 1 1 2 5 5 2 1 1 1 1 1 1 1 1 1 2 5 5 2 1 1 1 1 1 1 1 4 1 1 1 1 1 1 1 1 1 1 1 1
1 1 4 7 1 1 1 8 1 1 1 1 7 2 5 5 2 1 1 1 1 1 1 1 1 1 2 5 5 2 2 2 1 1 1 1 1 1 1 1 1 1 1 1 1 1 1 1 1 1
1 1 1 1 1 1 1 3 7 1 1 1 1 2 5 5 2 1 1 1 1 1 1 1 4 1 2 5 5 5 5 2 1 1 1 1 1 1 1 1 1 1 1 1 1 1 1 1 1 1
1 1 1 1 1 1 4 6 0 1 7 1 1 2 5 5 2 1 1 1 4 1 1 1 1 1 2 5 5 5 5 2 1 1 1 1 1 1 1 1 1 1 1 1 1 1 1 1 1 1
1 1 1 1 1 1 1 4 0 1 1 1 1 2 5 5 2 1 1 1 1 1 1 1 1 1 2 2 2 5 5 2 1 1 1 1 1 1 1 1 1 1 1 1 1 1 1 1 1 1
1 1 1 1 1 1 1 1 1 1 1 1 1 2 5 5 2 1 1 1 1 1 1 1 1 1 1 1 2 5 5 2 1 1 1 1 1 1 1 1 1 1 1 1 1 1 1 1 1 1
1 1 1 1 1 1 1 1 1 1 1 1 1 2 5 5 2 1 1 1 1 1 1 1 8 1 1 1 2 5 5 2 1 1 1 1 1 1 1 1 1 1 8 1 1 1 1 1 1 1
1 1 1 1 1 1 1 1 1 1 1 1 1 2 5 5 2 1 1 1 1 1 1 1 3 1 1 1 2 5 5 2 1 4 1 1 1 1 1 4 1 1 3 1 1 1 1 1 1 1
1 1 1 1 1 1 1 1 1 4 1 1 1 2 5 5 2 1 1 1 1 1 1 1 6 1 1 1 2 5 5 2 1 1 1 1 1 1 1 1 1 1 6 1 1 4 1 1 1 1
1 1 1 1 1 1 1 1 1 8 1 1 1 2 5 5 2 1 1 1 1 1 1 1 1 4 1 1 2 5 5 2 1 1 1 1 1 1 1 1 1 1 1 1 1 1 1 1 1 1
1 1 1 1 1 1 1 1 1 3 1 1 1 2 5 5 2 2 2 2 2 2 2 2 2 2 2 2 2 5 5 2 1 1 1 1 1 1 1 1 1 1 1 1 1 1 1 1 1 1
1 1 1 1 1 1 1 1 4 6 1 1 1 2 5 5 5 5 5 5 5 5 5 5 5 5 5 5 5 5 5 2 1 1 8 1 1 4 1 1 1 1 1 1 1 1 1 1 4 1
1 1 1 1 1 1 1 1 1 1 1 1 1 2 5 5 5 5 5 5 5 5 5 5 5 5 5 5 5 5 5 2 4 1 3 1 1 1 1 1 1 1 1 1 1 1 1 1 1 1
1 1 1 1 1 1 1 1 1 1 1 1 1 2 2 2 2 2 2 2 2 2 2 2 2 2 2 2 2 5 5 2 1 1 6 1 1 1 1 1 1 1 1 1 1 1 1 1 1 1
1 1 1 1 1 1 1 1 1 1 1 1 4 1 1 1 1 1 1 1 1 1 1 1 1 1 1 1 2 5 5 2 1 1 1 1 1 1 1 1 1 1 1 1 1 1 1 1 1 1
1 1 1 1 1 1 1 1 1 1 1 1 1 1 1 1 1 1 1 1 1 1 1 1 1 4 1 1 2 5 5 2 1 1 1 1 1 4 1 1 1 1 1 1 1 1 1 1 1 1
1 1 1 1 1 1 1 1 1 1 1 1 1 1 1 1 1 1 1 1 1 1 1 1 1 1 1 1 2 5 5 2 1 1 1 1 1 1 1 1 1 1 1 1 1 1 1 1 1 1
1 1 1 1 1 1 1 1 1 1 1 1 1 1 1 7 1 1 1 1 4 1 1 1 1 1 1 1 2 5 5 2 1 1 1 1 1 1 1 1 1 1 1 1 1 1 1 1 1 1
1 1 1 1 1 1 1 1 1 1 1 1 1 1 1 1 1 1 1 1 1 1 1 1 1 1 1 1 2 5 5 2 1 1 1 1 1 1 1 1 1 1 1 1 1 1 1 1 1 1
1 1 1 1 1 1 1 1 1 1 1 7 1 1 1 1 1 1 1 1 1 1 1 1 1 1 1 1 2 5 5 2 1 1 1 1 1 7 1 1 1 1 1 1 1 1 1 1 1 1
1 1 1 1 1 1 1 1 1 1 1 1 1 1 1 1 1 1 1 1 1 1 1 1 1 7 1 1 2 5 5 2 1 1 1 1 1 1 1 1 1 1 1 1 0 1 1 1 1 1
1 1 1 1 1 1 1 1 1 1 1 1 1 1 1 1 1 1 1 1 1 1 1 1 1 1 1 1 2 5 5 2 1 1 1 1 1 1 1 1 1 1 1 1 1 1 1 1 1 1
1 1 1 1 1 1 1 1 1 1 1 1 1 1 1 1 1 1 1 1 1 1 7 1 1 1 1 1 2 5 5 2 1 1 1 1 1 1 1 1 1 1 1 1 1 1 1 1 1 1
1 1 1 1 1 1 1 1 1 1 1 1 1 1 1 1 1 1 1 1 1 1 1 1 1 1 1 1 2 5 5 2 1 1 1 1 1 1 1 1 1 1 1 1 1 1 1 1 1 1
1 1 1 1 1 1 1 1 1 1 1 1 1 1 1 1 1 1 1 1 1 1 1 1 1 1 1 1 2 5 5 2 1 1 1 1 1 1 1 1 0 1 1 1 1 1 1 1 1 1
1 1 1 1 1 1 1 1 1 1 1 1 1 1 1 1 1 1 1 1 1 1 1 1 1 1 1 1 2 5 5 2 1 1 1 1 1 1 1 1 1 1 1 1 1 1 1 1 1 1